    NO Text/bluestone_test.xpm
SO Text/grey.xpm
EA Text/metal_wall.xpm
WE Text/marbel.xpm
    C   5  2 ,   97,235
F 52,229,235
1111
10001
10N01
10001
1111
