WE Text/W.xpm
    NO Text/N.xpm
    C 199, 104, 22
SO Text/S.xpm
EA Text/E.xpm



F 31, 1, 1


         11111111111111111111111
        1000000000110000000000001
        1011000001110000000000001
        10010000000000000000N0001
 11111111011000001110000000000001
100000000011000001110111111111111
11110111111111011100000010001
11110111111111011101010010001
11000000110101011100000010001
10000000000000001100000010001
10000000000000001101010000001
 1000101110101011111011110001111111111111
11110111 1110101 101111010001
11111    111111   1111111111
       1 1
       1111111111
