EA Text/E.xpm
WE Text/W.xpm
    C 255, 0, 69
    NO Text/N.xpm
SO Text/S.xpm
F 31, 1, 1

        1111111111111111111111111
        1000000000110000000000001
        1011000001110000000000001
        1001000000000000000000001  
111111111011000001110000000000001
100000000011000001110111111111111
111101111111110111000000100S1
11110111111111011101010010001
11000000110101011100000010001
10000000000000001100000010001
10000000000000001101010000001
11000101110101011111011110001111111111111
11110111 1110101 101111010001
11111111 11111111111111111111
       1 1
       1111111111