NO Text/marbel.xpm
SO Text/wall.xpm
EA Text/rough_wall.xpm
WE Text/redbrick.xpm
C 225,30,0
F 220,236,0

11111111111111111111111111
10000000000000000000000001
10000000000000000000000001
10000000000000000000000001
10000000000000000000000001
100000000000000000000N0001
10000000000000000000000001
10000000000000000000000001
10000000000000000000000001
10000000000000000000000001
10000000000000000000000001
10000000000000000000000001
10000000000000000000000001
11111111111111111111111111