NO Text/bluestone_test.xpm
SO Text/grey.xpm
EA Text/metal_wall.xpm
WE Text/mabel.xpm

F 0,0,0
C 255,255,255

1111111111
100000E001
1011111101
1010001101
1010111101
1011111101
1000000001
1111111111
