NO Text/bluestone_test.xpm
SO Text/grey.xpm
EA Text/metal_wall.xpm
WE Text/marbel.xpm

F 0,0,0
C 255,255,256

111111111111
1000000W0001
101111100001
101001111101
101011001101
111111100111
100010000001
111111111111
