NO Text/bluestone_test.xpm
SO Text/grey.xpm
EA Text/metal_wall.xpm
WE Text/marbel.xpm

F 100,100,100
C 255,0,0

11111
10E01
10101
10N01
11111
