NO Text/bluestone_test.xpm
SO Text/grey.xpm
EA Text/metal_wall.xpm
WE Text/marbel.xpm

F 0,0,0
C 255,255,255

11111111111111111111
1000000S000000000001
10111111111110000001
10100001000111110001
10111011000010011101
11111010000011101111
10000111011100011001
11110100110010111011
10001001100010000001
