NO Text/bluestone_test.xpm
SO Text/grey.xpm
EA Text/metal_wall.xpm
WE Text/marbel.xpm

F 255,0,255
C 0,255,0

111111111111111
10N000000000001
101111111111001
101000000100001
101011110111011
101110000111001
10000000F000111
111111111111111
