    NO Text/bluestone_test.xpm
SO Text/grey.xpm
EA Text/metal_wall.xpm
WE Text/marbel.xpm
    C 1  3  5   ,   2   6,1
F 194,178,128

        1111111111111111111111111
        1000000000110000000000001
        1011000001110000000000001
        10010000000000000000000N1
111111111011000001110000000000001
100000000011000001110111111111111
11110111111111011100000010001
11110111111111011101010010001
11000000110101011100000010001
10000000000000001100000010001
10000000000000001101010010001
11000101110101011111011110001111111111111
11110111 1110101 101111010001
11111111 11111111111111111101
       1 1111111111111111111
       1111111111